1111111111111
1001000X000C1
10X0011111001
1P0011E000001
1111111111111